# 8x8 maze is a discrete problem
# START: x y
0 0
# GOAL: x y
14 14
# Matrix:
0 0 0 0 0 0 1 0 0 0 0 0 0 0 0
1 1 1 1 1 0 1 0 1 1 1 1 1 1 0
0 0 0 0 1 0 1 0 1 0 0 0 0 0 0
0 1 1 0 1 0 1 0 1 0 1 1 1 1 1
0 1 0 0 1 0 1 0 1 0 1 0 0 0 0
0 1 0 1 1 0 1 0 1 0 1 0 1 1 0
0 1 0 0 0 0 1 0 1 0 1 0 1 0 0
0 1 1 1 1 1 1 0 1 0 1 0 1 0 1
0 0 0 0 0 0 0 0 1 0 1 0 1 0 1
1 1 1 1 1 1 1 1 1 0 1 0 1 0 1
0 0 0 0 0 0 0 0 0 0 1 0 1 0 1
0 1 1 1 1 1 1 1 1 1 1 0 1 0 1
0 1 0 0 0 0 0 0 0 0 0 0 1 0 1
0 1 0 1 1 1 1 1 1 1 1 1 1 0 1
0 0 0 0 0 0 0 0 0 0 0 0 0 0 0

