# --- City Names ---
Seattle
San Francisco
Los Angeles
Denver
Chicago
London
Paris
Amsterdam
Frankfurt
Madrid
Tokyo
Seoul
Shanghai
Hong Kong
Singapore

# --- Distance Matrix (10x10) ---
0    679  959  1021 1735 4784 5021 4870 5110 5250 4781 5210 5710 6500 8050
679  0    347  944  1854 5350 5580 5430 5670 5800 5140 5450 5950 6910 8430
959  347  0    831  1745 5450 5680 5530 5770 5900 5480 5790 6290 7250 8770
1021 944  831  0    919  4650 4880 4730 4970 5100 5820 6130 6630 7590 9110
1735 1854 1745 919  0    3950 4180 4030 4270 4400 6280 6590 7090 8050 9570
4784 5350 5450 4650 3950 0    213  221  406  785  5956 5900 5700 5990 6750
5021 5580 5680 4880 4180 213  0    268  294  652  6053 5990 5790 6080 6840
4870 5430 5530 4730 4030 221  268  0    228  910  5800 5740 5540 5830 6590
5110 5670 5770 4970 4270 406  294  228  0    890  5850 5790 5590 5880 6640
5250 5800 5900 5100 4400 785  652  910  890  0    6650 6590 6390 6680 7440
4781 5140 5480 5820 6280 5956 6053 5800 5850 6650 0    716  1095 1795 3300
5210 5450 5790 6130 6590 5900 5990 5740 5790 6590 716  0    540  1298 2850
5710 5950 6290 6630 7090 5700 5790 5540 5590 6390 1095 540  0    758  2350
6500 6910 7250 7590 8050 5990 6080 5830 5880 6680 1795 1298 758  0    1610
8050 8430 8770 9110 9570 6750 6840 6590 6640 7440 3300 2850 2350 1610 0

# --- Best Distance ---
23535