# 8x8 maze (discrete)
# START: x y
0 0
# GOAL: x y
5 3
# Matrix:
0 0 0 0 0 1 0 0 
0 0 0 0 0 1 0 0 
0 1 1 0 0 1 0 0
0 1 0 0 0 1 0 0
0 0 0 1 1 1 0 0
0 0 0 0 0 0 0 0
1 1 1 0 0 0 0 0
0 0 0 0 0 0 0 0