# 16x16 maze (discrete)
# START: x y
0 0
# GOAL: x y
15 15
# Matrix:
0 0 0 1 0 0 0 1 0 0 0 1 0 0 0 0
1 1 0 1 0 1 0 1 0 1 0 1 1 1 1 0
0 0 0 0 0 1 0 0 0 1 0 0 0 0 1 0
0 1 1 1 0 1 1 1 0 1 1 1 1 0 1 0
0 1 0 0 0 0 0 1 0 0 0 0 1 0 0 0
0 1 0 1 1 1 0 1 1 1 1 0 1 1 1 0
0 0 0 1 0 0 0 0 0 0 1 0 0 0 1 0
1 1 0 1 0 1 1 1 1 0 1 1 1 0 1 0
0 0 0 0 0 0 1 0 0 0 0 0 1 0 0 0
0 1 1 1 1 0 1 0 1 1 1 0 1 1 1 0
0 1 0 0 0 0 0 0 1 0 0 0 0 0 1 0
0 1 0 1 1 1 1 1 1 0 1 1 1 0 1 0
0 0 0 1 0 0 0 0 0 0 1 0 0 0 1 0
1 1 0 1 0 1 1 1 1 1 1 0 1 1 1 0
0 0 0 0 0 0 0 0 0 0 0 0 0 0 1 0
0 1 1 1 1 1 1 1 1 1 1 1 1 0 1 0